node_id,in_degree,out_degree,weighted_degree,strat,payoff,Run
33,99,91,190,0.622011130805209,80225,0
70,91,37,128,0.5034271838978747,8386,0
35,94,31,125,0.6275283159737647,8615,0
55,85,37,122,0.5941593901049763,8330,0
1,88,33,121,0.5640475465858562,8729,0
52,99,89,188,0.6529916003327432,52475,1
25,99,80,179,0.4688466302330869,49543,1
18,78,38,116,0.6740836723895676,7678,1
31,80,35,115,0.4300814655408611,7899,1
74,74,34,108,0.4967715569143744,7503,1
5,99,91,190,0.5943879956274093,78510,2
63,92,49,141,0.6689195217788462,7804,2
4,90,50,140,0.6350830366580078,7606,2
76,91,44,135,0.5394327958723343,7970,2
75,83,49,132,0.5590931086617946,7945,2
77,99,90,189,0.6846922315686755,85704,3
2,91,47,138,0.751506354778297,8336,3
32,89,45,134,0.6642912026224294,9742,3
86,92,42,134,0.7475508338794595,7979,3
64,89,45,134,0.6336987113686102,8738,3
49,99,86,185,0.5505402982159614,51424,4
77,99,85,184,0.6818950393369381,55837,4
7,87,44,131,0.6718696601405659,8376,4
0,96,32,128,0.5600934815067214,8513,4
21,85,35,120,0.8436371667816447,8264,4
64,99,88,187,0.44647379033674417,88752,5
39,90,33,123,0.44221310706349537,7144,5
68,88,32,120,0.6582515220862011,7444,5
71,85,30,115,0.4566252164890146,8327,5
26,81,32,113,0.4028079167493712,7345,5
66,99,90,189,0.5481061029989074,90216,6
87,91,52,143,0.48926286843687294,8093,6
22,84,50,134,0.5418848859463284,7677,6
73,82,51,133,0.6092827299967992,7335,6
40,85,48,133,0.6157679273928054,7461,6
95,99,89,188,0.4661186068846794,98308,7
83,90,49,139,0.42309437275148093,7916,7
91,88,48,136,0.5936581164601168,7488,7
31,76,51,127,0.4287138716923337,8019,7
57,78,47,125,0.6772509432449041,7421,7
19,99,91,190,0.6608257201646514,64847,8
90,91,34,125,0.9770555375277096,11669,8
58,87,38,125,1.0,7710,8
18,88,33,121,0.9823119575450447,7740,8
40,83,38,121,0.9252057578944424,7423,8
11,99,86,185,0.4516078417581743,93488,9
68,85,36,121,0.6308371130757329,7624,9
81,84,34,118,0.5970421612011241,7199,9
67,68,47,115,0.4396750166886336,7808,9
60,77,37,114,0.5187157465174658,7679,9
71,99,89,188,0.492053356089739,88344,10
46,90,39,129,0.4858733893799064,8590,10
73,82,32,114,0.4499740109203634,8031,10
52,80,26,106,0.4692763261702022,7928,10
70,65,31,96,0.4637878070074738,7507,10
86,99,90,189,0.6417507606804922,79530,11
9,93,31,124,0.609489812415896,8092,11
71,82,36,118,0.6707119851978637,7750,11
3,85,31,116,0.6050071129221379,7672,11
74,84,23,107,0.7141526540309228,7981,11
55,99,89,188,0.3939889709211369,67087,12
42,79,33,112,0.4245487865250084,7579,12
60,75,35,110,0.4325035619923044,7789,12
11,72,37,109,0.7194143257481516,7660,12
26,76,32,108,0.3631183366739456,7649,12
95,99,90,189,0.5574107217643031,97457,13
4,97,26,123,0.5855868309002009,9868,13
65,87,35,122,0.5881663192725073,7925,13
66,89,31,120,0.6251089284813477,8213,13
76,86,30,116,0.6049390857885203,7835,13
75,99,83,182,0.4692441404485558,58697,14
27,99,83,182,0.3817686791839572,59364,14
8,79,28,107,0.4239010733700114,7580,14
33,70,30,100,0.5955300522899623,7492,14
22,63,33,96,0.5237031138103091,7485,14
9,99,88,187,0.6999264936664478,59103,15
2,99,85,184,0.710482965003162,59862,15
90,95,30,125,0.5094495766442249,8310,15
16,83,42,125,0.8234142025527328,8410,15
91,86,33,119,0.7081043060010109,8758,15
78,99,88,187,0.6061530810376532,72205,16
21,94,32,126,0.5701283877298531,7790,16
7,89,33,122,0.55843271914755,8271,16
2,87,29,116,0.6621986069978698,7862,16
4,77,31,108,0.6448763685203011,7636,16
56,99,87,186,0.5222185717020408,96433,17
44,82,33,115,0.4733689326282186,7576,17
3,83,30,113,0.5704402977791918,9354,17
24,73,22,95,0.4608054920542805,7796,17
21,69,26,95,0.4623812232881812,8032,17
18,99,93,192,0.5939302783177367,113500,18
33,86,54,140,0.6496690774671221,8401,18
66,85,51,136,0.4994076674274439,8298,18
38,88,47,135,0.6453550538162006,8613,18
96,84,51,135,0.606538999968269,8326,18
42,99,90,189,0.5821439428867977,64550,19
43,88,31,119,0.5915549029910683,7879,19
79,80,27,107,0.5936254561369182,8095,19
27,71,31,102,0.4876100812640554,7928,19
82,64,33,97,0.212094216602874,8154,19
90,99,86,185,0.5666288696072704,49226,20
10,99,76,175,0.4646092248163826,50623,20
53,84,30,114,0.4700111783203725,7690,20
41,73,37,110,0.6595094062180535,7553,20
73,69,28,97,0.6290723224330507,7932,20
31,99,91,190,0.6711775452481196,82575,21
76,96,38,134,0.6909376214520235,8402,21
13,85,32,117,0.6649014831102208,8308,21
26,77,32,109,0.6632720947175286,8136,21
88,72,31,103,0.7528595831142842,8234,21
64,99,87,186,0.6808627134470544,60023,22
3,99,85,184,0.6994522614691658,58582,22
42,77,34,111,0.6837640057444005,8450,22
92,75,32,107,0.7155965034478515,8638,22
96,70,37,107,0.6244076328816068,8392,22
7,99,91,190,0.577139882711746,80201,23
48,95,39,134,0.6831913478567674,8424,23
28,85,49,134,0.759251361043844,9399,23
66,90,33,123,0.6320341535254206,8632,23
47,83,36,119,0.683308067864261,8223,23
7,99,89,188,0.6030947923622819,72307,24
45,90,41,131,0.4550408304150882,8185,24
65,92,37,129,0.7708351947404682,8102,24
59,91,34,125,0.6577979628900401,8046,24
85,80,34,114,0.5861940407807011,7558,24
56,99,90,189,0.5472247915751524,104404,25
9,91,34,125,0.4466232427439703,7957,25
47,89,36,125,0.6068822539059772,8162,25
70,90,32,122,0.5168364194912439,7965,25
19,87,27,114,0.6366752334182595,7986,25
12,99,88,187,0.6947030119530487,61048,26
53,99,80,179,0.4986686875710631,57612,26
69,88,36,124,0.7661334279616138,7879,26
29,67,41,108,0.4911956549583663,7803,26
15,72,33,105,0.7265600515243026,7936,26
16,99,88,187,0.5589952183505167,77056,27
54,90,35,125,0.5839234345829288,8604,27
51,86,32,118,0.6189026153592925,7935,27
63,84,29,113,0.6026403082530302,7772,27
23,76,30,106,0.5813757308630702,11955,27
72,99,87,186,0.6854747355978703,94703,28
76,91,43,134,0.7591334299883495,11235,28
43,88,44,132,0.5001890580169837,8622,28
45,82,49,131,0.5733552189232607,8460,28
74,80,45,125,0.7097267979815122,8155,28
28,99,86,185,0.4643017976243083,94880,29
70,91,44,135,0.8283909943613921,7652,29
18,84,40,124,0.6159574033695172,7568,29
99,80,43,123,0.4422938363352196,7985,29
96,73,44,117,0.4619922238832714,7461,29
36,99,84,183,0.6490337240213891,46956,30
45,99,82,181,0.5581537226773596,51554,30
93,82,29,111,0.6507790942340999,8053,30
20,68,36,104,0.6597455368533045,8013,30
35,72,27,99,0.6957174855208933,8613,30
71,99,89,188,0.6202179799495091,63161,31
98,93,39,132,0.5738471431963248,8013,31
33,94,33,127,0.6849968374487836,10761,31
64,86,30,116,0.6311898849284154,8059,31
30,81,33,114,0.3662491755034281,8256,31
8,99,86,185,0.6372291715653613,64892,32
77,99,86,185,0.6287346820559854,63328,32
22,88,35,123,0.6961759810526154,10993,32
42,87,33,120,0.5006596128345904,8409,32
95,77,39,116,0.7406659263333178,8158,32
29,99,86,185,0.6920089688529182,58859,33
87,89,34,123,0.7186711212258141,8486,33
25,75,41,116,0.6974312291057386,8300,33
30,82,31,113,0.6730979393499646,8663,33
31,78,30,108,0.6153094329555973,8142,33
15,99,86,185,0.6010645285959408,54089,34
37,99,84,183,0.6246528430118834,52558,34
4,91,29,120,0.8861932188023043,7972,34
56,78,40,118,0.6080090963364027,8344,34
59,86,29,115,0.8708789070584119,9184,34
8,99,85,184,0.6019593264543968,83612,35
53,78,51,129,0.6395512835601833,7917,35
49,79,49,128,0.6290982036351734,8113,35
91,81,45,126,0.8217225890223786,7807,35
77,80,46,126,0.6718987046208812,7390,35
21,99,88,187,0.4989551058459295,100532,36
42,96,35,131,0.5834233910330079,7938,36
0,93,32,125,0.6145239783015967,7574,36
92,88,30,118,0.5395966786077876,8885,36
31,87,29,116,0.6275460533817869,7668,36
86,99,94,193,0.6867217460588771,60193,37
94,90,41,131,0.6636730897471429,8493,37
92,86,43,129,0.6662151993086369,8557,37
6,87,41,128,0.7249421128419399,8514,37
22,90,32,122,0.6541386780863764,8055,37
52,99,91,190,0.63702608366825,65057,38
69,96,42,138,0.6610695735596619,8342,38
33,93,43,136,0.6001720593564852,8807,38
21,88,44,132,0.6586740968096281,8220,38
14,94,35,129,0.6532993502208508,8152,38
94,99,86,185,0.4836037576086659,56771,39
10,95,34,129,0.5980887878181337,35974,39
53,84,24,108,0.5165176319575179,22577,39
91,69,28,97,0.5156552007896118,7632,39
52,67,23,90,0.5119344783498099,7504,39
83,99,86,185,0.6426433433239326,83677,40
79,89,35,124,0.6903291323159235,7889,40
72,80,34,114,0.6769673069372385,8638,40
93,83,31,114,0.7059562430395474,8349,40
39,83,29,112,0.8343801441513837,8367,40
27,99,93,192,0.5929360463475748,107720,41
58,97,39,136,0.6112134698851617,8864,41
97,90,28,118,0.5967682620226414,8806,41
80,72,38,110,0.7387001891310063,8416,41
60,77,32,109,0.5704081620805036,8642,41
82,99,90,189,0.5338343960894162,86258,42
61,86,31,117,0.5357593930472341,7916,42
13,83,32,115,0.5466622802400394,7892,42
93,75,37,112,0.5747828421252813,7963,42
7,75,33,108,0.5392620167310026,7674,42
58,99,91,190,0.6116529605644218,104001,43
81,91,54,145,0.793594675819024,8225,43
61,87,50,137,0.5696770796252004,8336,43
38,84,52,136,0.5104759592751786,8232,43
4,80,56,136,0.6059763997302414,8737,43
87,99,89,188,0.6843723594489253,50007,44
41,90,27,117,0.6755218171993614,7968,44
99,88,27,115,0.7187492723891122,7909,44
66,75,27,102,0.5962208940041906,8103,44
3,74,27,101,0.6830267330374189,8258,44
83,99,86,185,0.5442699379158225,53742,45
13,99,81,180,0.6180284973862331,55246,45
75,94,36,130,0.6625155125966741,8074,45
99,86,34,120,0.6371028295526489,7667,45
18,87,32,119,0.5992418735605476,8483,45
17,99,90,189,0.5555796263916237,100365,46
70,91,50,141,0.597098393692947,7862,46
81,86,53,139,0.4357836361289253,7648,46
76,80,55,135,0.6118984077999939,8441,46
54,86,48,134,0.5668499247396586,7788,46
75,99,83,182,0.31327265682158034,94774,47
72,87,23,110,0.3946278150378452,7381,47
61,82,23,105,0.3524144436974023,7630,47
66,75,16,91,0.36978121479512616,7435,47
9,73,16,89,0.3174269969722681,7414,47
44,99,93,192,0.5243591084998142,62883,48
45,89,43,132,0.5876398933566459,7628,48
75,82,48,130,0.6486059778450255,7906,48
80,72,49,121,0.5780119612903427,7270,48
66,79,41,120,0.5730260307682473,7346,48
24,99,82,181,0.5481147112021537,49778,49
20,99,81,180,0.5563090417185421,49185,49
46,85,37,122,0.6578596167668371,8007,49
15,86,31,117,0.5330414361135596,7963,49
56,84,32,116,0.6901369269508363,10665,49
