node_id,in_degree,out_degree,weighted_degree,strat,payoff,Run
31,99,96,195,0.646123971108656,141961,0
73,86,34,120,0.6441118151929611,8264,0
8,89,31,120,0.8357923761740779,8379,0
57,86,30,116,0.9063737717792032,8107,0
15,82,33,115,0.6415333464640839,8797,0
38,99,95,194,0.5368968206370963,110587,1
88,77,35,112,0.5852745211963937,7969,1
34,75,35,110,0.6590606947890846,7496,1
16,76,33,109,0.5820537417950593,8647,1
42,79,29,108,0.5562698813928528,7530,1
16,99,91,190,0.6797581892372975,110017,2
18,89,35,124,0.645419465587956,17704,2
92,86,38,124,0.7841677311526146,7991,2
42,77,46,123,0.7491196582013183,8130,2
0,82,38,120,0.6332003503738205,10696,2
52,99,92,191,0.6425602265587023,103009,3
84,89,52,141,0.7163091104239979,8106,3
87,85,50,135,0.3883200760607433,7947,3
23,85,49,134,0.7035378696216619,8605,3
11,78,56,134,0.5301980597269769,7694,3
79,99,90,189,0.7188666403859956,81915,4
41,92,38,130,0.7562511887491908,7967,4
5,85,43,128,0.6769141565700811,7665,4
52,85,40,125,0.7637798509242345,7852,4
22,82,42,124,0.6072246559283759,8221,4
37,99,92,191,0.6763904004351997,99470,5
67,95,42,137,0.7333556544338309,7647,5
3,79,53,132,0.6470994709070392,7844,5
10,85,43,128,0.6715954219051049,8273,5
82,80,48,128,0.7345339227480578,7955,5
82,99,95,194,0.6685126922325627,91338,6
79,94,32,126,0.8185922164464194,7958,6
72,85,26,111,0.831550710422534,8203,6
86,82,25,107,0.8252195279310369,8289,6
49,73,28,101,0.6966000763297906,8045,6
93,99,95,194,0.4845977751985288,124050,7
26,84,40,124,0.5284783297843605,7501,7
82,87,34,121,0.4884480914950711,7587,7
90,73,28,101,0.4735677087426494,22064,7
33,72,19,91,0.5643399510303011,7578,7
51,99,98,197,0.5788835067237941,132370,8
58,86,48,134,0.6208431422593023,7755,8
33,88,45,133,0.5428542089972186,7990,8
59,85,43,128,0.8090538621319093,7564,8
40,73,53,126,0.5835586008103889,8051,8
69,99,94,193,0.6979535626628449,76102,9
92,94,37,131,0.6419625561315898,48128,9
23,84,32,116,0.6356443917313044,8231,9
12,83,28,111,0.6825913225410667,7171,9
28,75,27,102,0.5815315649129524,7546,9
87,99,86,185,0.5080438777285652,107285,10
96,92,33,125,0.6050093291184891,7172,10
95,83,32,115,0.35939407224720304,10137,10
76,75,33,108,0.38505968002090224,7807,10
28,80,26,106,0.6447579127077174,7294,10
70,99,89,188,0.5237180566441579,124753,11
80,92,36,128,0.5244968485214954,7314,11
50,90,31,121,0.5473176556628535,15213,11
34,79,35,114,0.5318896293418687,7855,11
13,65,22,87,0.4862692241416878,7606,11
1,99,90,189,0.5629890010629022,59673,12
34,99,82,181,0.4941173459651512,63061,12
61,87,29,116,0.5258774578057345,7477,12
74,82,31,113,0.5778544302144142,8217,12
13,74,28,102,0.5302653798880264,51325,12
71,99,96,195,0.6472966082432203,142217,13
63,90,36,126,0.5814885560659618,8500,13
2,85,40,125,0.7089080362367612,8398,13
29,87,38,125,0.8067938244835612,8120,13
21,84,39,123,0.8330691332546688,8127,13
14,99,93,192,0.6605852345098795,120155,14
33,96,45,141,0.9383185780471416,7939,14
44,90,43,133,0.8769768849341042,7853,14
89,87,43,130,0.6318843488101242,7950,14
87,92,36,128,0.7838492192411749,7685,14
76,99,96,195,0.6777997978182311,149827,15
37,90,45,135,0.6964046925317484,8589,15
34,88,43,131,0.811346656874963,8069,15
97,86,45,131,0.6971476607184934,8520,15
75,88,40,128,0.7519768670510427,8373,15
31,99,94,193,0.6793534176428451,119666,16
23,87,33,120,0.6457405822091831,8026,16
6,88,26,114,0.6356662349150446,8130,16
0,79,28,107,0.7273472964106946,7803,16
39,68,32,100,0.5971745199123306,8121,16
93,99,96,195,0.6680743048057202,143576,17
31,90,46,136,0.8005831238518699,9175,17
97,87,35,122,0.6666120532979273,8544,17
8,82,29,111,0.6802855561895635,7882,17
0,72,37,109,0.6721250886338301,9317,17
61,99,88,187,0.5173932354224688,118265,18
36,88,34,122,0.7246119603015329,7251,18
3,93,26,119,0.49439695531744005,8167,18
2,82,32,114,0.4913925884706544,7672,18
88,78,30,108,0.4793959157062292,7613,18
94,99,95,194,0.5355404685633924,127681,19
50,85,38,123,0.6448322158831002,7334,19
26,79,30,109,0.6355296690276344,7501,19
86,80,29,109,0.6318857948074004,7094,19
45,72,34,106,0.4648485786194802,7782,19
29,99,93,192,0.5773752890957303,129627,20
0,97,40,137,0.6349874677812856,8418,20
20,83,29,112,0.6037870781062453,7177,20
21,78,27,105,0.6469493000972291,8165,20
45,76,28,104,0.6137707975791132,7716,20
90,99,89,188,0.6845719061549329,79717,21
29,87,42,129,0.7821036915979066,7715,21
94,93,34,127,0.5799330190910045,7860,21
98,89,38,127,0.6796392837289357,7955,21
46,79,41,120,0.6030954954398651,7622,21
98,99,89,188,0.5433631368246075,99642,22
18,91,36,127,0.4651665862518569,32775,22
77,89,28,117,0.5476665885661811,8174,22
85,76,29,105,0.5631727557135966,7550,22
71,80,21,101,0.5275573412115617,8059,22
94,99,93,192,0.6603480041378111,87029,23
19,85,36,121,0.6795936596287719,8618,23
80,84,30,114,0.6534631810239402,8073,23
21,79,30,109,0.6643344952289607,8168,23
43,76,30,106,0.8939309800475149,7629,23
62,99,86,185,0.4907582825777753,84026,24
5,99,86,185,0.5683546921063993,85898,24
80,67,27,94,0.5607762569758621,7270,24
39,61,32,93,0.5401670091790399,7675,24
27,59,30,89,0.5524628935122275,7377,24
86,99,93,192,0.5440548536571538,138988,25
4,89,40,129,0.5661705081089355,8689,25
2,88,35,123,0.615250312430885,7756,25
90,86,36,122,0.5705414280685607,8173,25
47,85,33,118,0.8174903560225186,8028,25
29,99,92,191,0.5174033329984333,92721,26
71,96,37,133,0.6096587167321268,9229,26
70,89,30,119,0.7776478354134752,7329,26
74,79,30,109,0.5254931835467174,7508,26
89,74,31,105,0.8624217493897194,54497,26
16,99,88,187,0.5589952183505167,77187,27
76,99,86,185,0.5217085169035858,77391,27
35,75,31,106,0.490514239858759,7604,27
3,81,25,106,0.6073775562695078,7564,27
32,75,27,102,0.4219272871671697,7619,27
28,99,94,193,0.6084209838041705,129220,28
24,84,44,128,0.6116636812236562,7616,28
47,83,45,128,0.6448533702004089,7853,28
71,82,45,127,0.5413381187422545,7681,28
46,80,46,126,0.5721815014872201,8170,28
21,99,95,194,0.6170870354288391,82748,29
69,99,88,187,0.6039133836210264,83232,29
19,76,33,109,0.784813406308775,7642,29
5,77,32,109,0.5913270534235445,7829,29
77,76,30,106,0.6200038516882587,7758,29
51,99,84,183,0.6749084641220499,68492,30
49,99,76,175,0.508007375412144,64824,30
7,68,25,93,0.6473716515195629,8256,30
54,66,27,93,0.5513822489074304,7902,30
48,67,24,91,0.6734211122358023,7971,30
33,99,95,194,0.6955911438954236,116371,31
7,88,42,130,0.608528765216083,8293,31
67,84,43,127,0.6035419122895832,8090,31
37,90,36,126,0.946783254726452,8563,31
24,81,44,125,0.5483441258648833,8300,31
45,99,94,193,0.6949046948233917,90708,32
64,97,38,135,0.7410066294198201,49127,32
59,92,38,130,0.6886732656394271,8571,32
1,82,30,112,0.7822389568894614,8005,32
73,73,37,110,0.6500738325363613,7880,32
25,99,95,194,0.5222431891106392,136099,33
15,83,37,120,0.4559851289608233,7537,33
31,83,31,114,0.448698706038,7140,33
93,83,31,114,0.4792527850535684,8067,33
73,79,32,111,0.5897667225456669,7257,33
69,99,96,195,0.6483207328769685,135583,34
6,96,54,150,0.7381105447129767,8180,34
48,84,56,140,0.6783112810714912,7872,34
84,86,51,137,0.5466100433556964,7944,34
87,86,51,137,0.6149391436490699,7816,34
93,99,91,190,0.5606763823612624,124789,35
87,89,39,128,0.607685538669734,7626,35
65,89,35,124,0.788732810025626,7444,35
58,89,33,122,0.5101708005230319,7819,35
57,87,34,121,0.5896993731407552,7657,35
46,99,93,192,0.6947638950567037,113845,36
94,92,47,139,0.4913078823778767,8230,36
45,82,50,132,0.7703779108068709,7852,36
1,84,46,130,0.6511232244383106,8018,36
6,81,46,127,0.4626786743987864,8116,36
40,99,90,189,0.6442327798059607,83121,37
68,99,89,188,0.6120085830782358,78655,37
94,87,30,117,0.6927327665334089,7545,37
93,78,25,103,0.8769773450849292,7545,37
76,70,30,100,0.6739282056345782,7832,37
75,99,91,190,0.4054811245091071,120936,38
33,81,26,107,0.4948398798153779,7317,38
45,76,27,103,0.4866960695902569,7004,38
22,73,22,95,0.4902832449035253,6932,38
29,69,26,95,0.4611214747426062,6847,38
33,99,92,191,0.6778900260000118,92716,39
87,87,36,123,0.724504372298385,7337,39
77,84,31,115,0.669850937335161,8383,39
82,77,35,112,0.7786549278456039,8051,39
57,85,27,112,0.6785135405997053,7389,39
70,99,93,192,0.6624080455976288,101027,40
72,85,49,134,0.7790646396046277,8465,40
54,88,45,133,0.5339624891267182,8056,40
6,82,45,127,0.729949012222866,8115,40
64,84,43,127,0.6450530666124025,8342,40
3,99,97,196,0.6655333739090852,135399,41
19,95,47,142,0.641144349909472,8455,41
52,93,47,140,0.6938592299934354,8709,41
86,96,41,137,0.7709670632828778,8737,41
6,93,39,132,0.8529205090460409,8620,41
74,99,92,191,0.562175466117952,109164,42
70,95,37,132,0.7108209199744692,7996,42
41,91,36,127,0.6578468367970572,7699,42
67,84,34,118,0.6241358974052043,8225,42
71,79,24,103,0.5004653660844322,8388,42
30,99,89,188,0.6356392805746975,112859,43
53,96,37,133,0.7755458058578243,8321,43
31,94,36,130,0.6770736976168942,8320,43
6,95,30,125,0.8024986065777278,8195,43
88,89,28,117,0.6619347646416299,8399,43
17,99,93,192,0.6366091587624836,126872,44
18,94,31,125,0.6158141309410352,8146,44
83,84,36,120,0.5830081668957741,9778,44
48,83,31,114,0.680783095532667,7853,44
84,80,33,113,0.5699657403230642,21177,44
4,99,94,193,0.6312359892864219,81108,45
12,93,49,142,0.6724850674616321,7724,45
85,90,38,128,0.6747100831273609,7803,45
61,85,34,119,0.6386308606102575,8096,45
30,82,36,118,0.5671082476939102,8034,45
76,99,95,194,0.6279294260732804,128865,46
40,97,41,138,0.622470126900106,8290,46
32,88,37,125,0.5353007378768193,8303,46
64,79,37,116,0.6109336906289672,8141,46
16,78,31,109,0.6149875437713423,7918,46
44,99,92,191,0.5699418421755764,135766,47
98,90,38,128,0.6123387849162194,7696,47
55,87,34,121,0.8591267533784893,7167,47
33,83,36,119,0.5926156031733117,7987,47
85,82,32,114,0.4651748425401772,7952,47
97,99,95,194,0.6110878261096947,108348,48
63,91,40,131,0.7118898958774623,8051,48
16,88,36,124,0.6328058718009325,7981,48
66,83,39,122,0.5583141875507158,8085,48
81,84,33,117,0.6004453566449112,8246,48
88,99,92,191,0.6899953291338217,129433,49
71,93,38,131,0.5919644702765254,8161,49
2,91,30,121,0.6842904526870305,8505,49
79,72,34,106,0.6254661823917892,8509,49
67,78,26,104,0.7414082595644489,7781,49
